10 10

W W W W W W W W W W
W 0 0 0 0 0 0 0 0 W
W 0 BG 0 0 0 0 0 0 W
W 0 0 0 0 0 0 wg 0 W
W 0 B B b 0 0 0 0 W
W 0 0 0 0 0 0 0 0 W
W 0 0 0 wg 0 0 0 0 W
W 0 wg 0 0 c 0 0 0 W
W 0 0 0 0 0 0 S 0 W
W W W W W W W W W W